*****************************************************
*                                                   *
*                     .......                       *
*                ........... ......                 *
*                                                   *
* .......... ........... ... .. ...... ..... ...    *
* ........ ...... . ........ ......... ..... .....  *
* ...... ....... ... ...                            *
*                                                   *
* ............. . ............. ........ .......    *

*                                                   *
*                        S..... O...... P...... SR  *
*                                                   *
*****************************************************